{
	"numTilesX":40,
	"numTilesY":27,
	"size":[32,32],
	"start":[16,0],
	"tileNames":["", "grassTopLeft", "grassTopMid", "grassTopRight", "dirtMidLeft", "dirtMidMid", "dirtMidRight", "grassEdgeRight", "grassEdgeLeft", "ruinTopLeft", "ruinTopMid", "ruinTopRight",
				 "ruinMidLeft", "ruinMidMid", "ruinMidRight", "caveBackMid", "caveBackRight"],
	"tiles":[
			 0,  0,  0,  0,  0,  0,  0,  0,  0,  0,  0,  0,  0,  0,  0,  0,  0,  0,  0,  0,  0,  0,  0,  0,  0,  0,  0,  0,  0,  0,  0,  0,  0,  0,  0,  0,  0,  0,  0,  0,
			 0,  0,  0,  0,  0,  0,  0,  0,  0,  0,  0,  0,  0,  0,  0,  0,  0,  0,  0,  0,  0,  0,  0,  0,  0,  0,  0,  0,  0,  0,  0,  0,  0,  0,  0,  0,  0,  0,  0,  0,
			 0,  0,  0,  0,  0,  0,  0,  0,  0,  0,  0,  0,  0,  0,  0,  0,  0,  0,  0,  0,  0,  0,  0,  0,  0,  0,  0,  0,  0,  0,  0,  0,  0,  0,  0,  0,  0,  0,  0,  0,
			 0,  0,  0,  0,  0,  0,  0,  0,  0,  0,  0,  0,  0,  0,  0,  0,  0,  0,  0,  0,  0,  0,  0,  0,  0,  0,  0,  0,  0,  0,  0,  0,  0,  0,  0,  0,  0,  0,  0,  0,
			 0,  0,  0,  0,  0,  0,  0,  0,  0,  0,  0,  0,  0,  0,  0,  0,  0,  0,  0,  0,  0,  0,  0,  0,  0,  0,  0,  0,  0,  0,  0,  0,  0,  0,  0,  0,  0,  0,  0,  0,
			 0,  0,  0,  0,  0,  0,  0,  0,  0,  0,  0,  0,  0,  0,  0,  0,  0,  0,  0,  0,  0,  0,  0,  0,  0,  0,  0,  0,  0,  0,  0,  0,  0,  0,  0,  0,  0,  0,  0,  0,
			 0,  0,  0,  0,  0,  0,  0,  0,  0,  0,  0,  0,  0,  0,  0,  0,  0,  0,  0,  0,  0,  0,  0,  0,  0,  0,  0,  0,  0,  0,  0,  0,  0,  0,  0,  0,  0,  0,  0,  0,
			 0,  0,  0,  0,  0,  0,  0,  0,  0,  0,  0,  0,  0,  0,  0,  0,  0,  0,  0,  0,  0,  0,  0,  0,  0,  0,  0,  0,  0,  0,  0,  0,  0,  0,  0,  0,  0,  0,  0,  0,
			 0,  0,  0,  0,  0,  0,  0,  0,  0,  0,  0,  0,  0,  0,  0,  0,  0,  0,  0,  0,  0,  0,  0,  0,  0,  0,  0,  0,  0,  0,  0,  0,  0,  0,  0,  0,  0,  0,  0,  0,
			 0,  0,  0,  0,  0,  0,  0,  0,  0,  0,  0,  0,  0,  0,  0,  0,  0,  0,  0,  0,  0,  0,  0,  0,  0,  0,  0,  0,  0,  0,  0,  0,  0,  0,  0,  0,  0,  0,  0,  0,
			 0,  0,  0,  0,  0,  0,  0,  0,  0,  0,  0,  0,  0,  0,  0,  0,  0,  0,  0,  0,  0,  0,  0,  0,  0,  0,  0,  0,  0,  0,  0,  0,  0,  0,  0,  0,  0,  0,  0,  0,
			 0,  0,  0,  0,  0,  0,  0,  0,  0,  0,  0,  0,  0,  0,  0,  0,  0,  0,  0,  0,  0,  0,  0,  0,  0,  0,  0,  0,  0,  0,  0,  0,  0,  0,  0,  0,  0,  9, 11,  0,
			 0,  0,  0,  0,  0,  0,  0,  0,  0,  0,  0,  0,  0,  0,  0,  0,  0,  0,  0,  0,  0,  0,  0,  0,  0,  0,  0,  0,  0,  0,  0,  0,  0,  0,  0,  0,  0, 12, 14,  0,
			 0,  1,  2,  2,  2,  2,  2,  3,  0,  0,  0,  0,  0,  0,  0,  0,  0,  0,  0,  0,  0,  0,  0,  0,  0,  0,  0,  0,  0,  9, 10, 10, 11,  0,  0,  0,  0, 12, 14,  0,
			 0,  4,  5,  5,  5,  5,  5,  8,  2,  2,  3,  0,  0,  0,  0,  0,  0,  0,  0,  0,  0,  0,  0,  0,  1,  2,  3,  0,  0,  0, 12, 14,  0,  0,  0,  0,  0, 12, 14,  0,
			 0,  4,  5,  5,  5,  5,  5,  5,  5,  5,  6,  0,  0,  0,  0,  0,  0,  0,  0,  1,  3,  0,  0,  0,  0,  0,  0,  0,  0,  0, 12, 14,  0,  0,  0,  0,  0, 12, 14,  0,
			 0,  4,  5,  5,  5,  5,  5,  5,  5,  5,  6,  0,  0,  0,  0,  0,  0,  0,  0,  4,  8,  3,  0,  0,  0,  0,  0,  0,  0,  0, 12, 14,  0,  0,  9, 11,  0, 12, 14,  0,
			 0,  4,  5,  5,  5,  5,  5,  5,  5,  5,  6,  0,  0,  0,  0,  0,  1,  2,  2,  7,  5,  6,  0,  0,  0,  0,  0,  1,  2,  2,  2,  2,  2,  2,  2,  2,  2,  2,  3,  0,
			 0,  4,  5,  5,  5,  5,  5,  5,  5,  5,  8,  2,  2,  2,  2,  2,  7,  5,  5,  5,  5,  6,  0,  0,  0,  0,  0,  4,  5,  5,  5,  5,  5,  5,  5,  5,  5,  5,  6,  0,
			 0,  4,  5,  5,  5,  5,  5,  5,  5,  5,  5,  5,  5,  5,  5,  5,  5,  5,  5,  5,  5,  6,  0,  0,  0,  1,  2,  7,  5,  5,  5,  5,  5,  5,  5,  5,  5,  5,  6,  0,
			 0,  4,  5,  5,  5,  5,  5,  5,  5,  5,  5,  5,  5,  5,  5,  5,  5,  5,  5,  5,  5,  6,  0,  0,  0,  4,  5,  5,  5,  5,  5,  5,  5,  5,  5,  5,  5,  5,  6,  0,
			 0,  4,  5,  5,  5,  5,  5,  5,  5,  5,  5,  5,  5,  5,  5,  5,  5,  5,  5,  5,  5,  6,  0,  0,  0,  4,  5,  5,  5,  5,  5,  5,  5,  5,  5,  5,  5,  5,  6,  0,
			 0,  4,  5,  5,  5,  5,  5,  5,  5,  5,  5,  5,  5,  5,  5,  5,  5,  5,  5,  5,  5,  6,  0,  0,  0,  4,  5,  5,  5,  5,  5,  5,  5,  5,  5,  5,  5,  5,  6,  0,
			 0,  4,  5,  5,  5,  5,  5,  5,  5,  5,  5,  5,  5,  5,  5,  5,  5,  5,  5,  5,  5,  6,  0,  0,  0,  4,  5,  5,  5,  5,  5,  5,  5,  5,  5,  5,  5,  5,  6,  0
			]								    
}